MAPPING	0


R00004	0	0	C00013	5	C00009	0
R00004	0	0	C00013	1	C00009	1
R00004	0	0	C00013	6	C00009	2
R00004	0	0	C00013	7	C00009	3
R00004	0	0	C00013	8	C00009	4
R00004	0	1	C00001	0	C00009_1	1
