MAPPING	0


R00297	0	0	C00256	0	C00022	1
R00297	0	0	C00256	1	C00022	2
R00297	0	0	C00256	2	C00022	0
R00297	0	0	C00256	3	C00022	4
R00297	0	0	C00256	5	C00022	3
R00297	0	0	C00256	4	C00022	5
