MAPPING	0


R00579	0	0	C00064	0	C00819	0
R00579	0	0	C00064	1	C00819	1
R00579	0	0	C00064	2	C00819	2
R00579	0	0	C00064	3	C00819	3
R00579	0	0	C00064	4	C00819	4
R00579	0	0	C00064	5	C00819	6
R00579	0	0	C00064	6	C00819	5
R00579	0	0	C00064	7	C00819	7
R00579	0	0	C00064	8	C00819	8
R00579	0	0	C00064	9	C00819	9
