MAPPING	0


R00877	0	0	C00159	8	C00095	0
R00877	0	0	C00159	4	C00095	1
R00877	0	0	C00159	2	C00095	2
R00877	0	0	C00159	6	C00095	3
R00877	0	0	C00159	11	C00095	4
R00877	0	0	C00159	1	C00095	5
R00877	0	0	C00159	9	C00095	6
R00877	0	0	C00159	0	C00095	7
R00877	0	0	C00159	10	C00095	8
R00877	0	0	C00159	5	C00095	9
R00877	0	0	C00159	3	C00095	10
R00877	0	0	C00159	7	C00095	11
