MAPPING	0


R00901	0	0	C00097	6	C00283	0
R00901	0	1	C00094	0	C00506	0
R00901	0	1	C00094	1	C00506	2
R00901	0	1	C00094	2	C00506	9
R00901	0	1	C00094	3	C00506	8
R00901	0	2	C00097	0	C00506	3
R00901	0	2	C00097	1	C00506	4
R00901	0	2	C00097	2	C00506	1
R00901	0	2	C00097	3	C00506	5
R00901	0	2	C00097	4	C00506	7
R00901	0	2	C00097	5	C00506	6
