MAPPING	0


R08195	0	0	C00820	1	C00037	0
R08195	0	0	C00820	2	C00037	1
R08195	0	0	C00820	0	C00037	2
R08195	0	0	C00820	5	C00037	3
R08195	0	0	C00820	7	C00037	4
R08195	0	1	C00820	3	C00084	1
R08195	0	1	C00820	4	C00084	0
R08195	0	1	C00820	6	C00084	2
