MAPPING	0


RP00992	0	0	C00064	0	C00819	0
RP00992	0	0	C00064	1	C00819	1
RP00992	0	0	C00064	2	C00819	2
RP00992	0	0	C00064	3	C00819	3
RP00992	0	0	C00064	4	C00819	4
RP00992	0	0	C00064	5	C00819	6
RP00992	0	0	C00064	6	C00819	5
RP00992	0	0	C00064	7	C00819	7
RP00992	0	0	C00064	8	C00819	8
RP00992	0	0	C00064	9	C00819	9
