MAPPING	0


RP00133	0	0	C00064	0	C00940	0
RP00133	0	0	C00064	1	C00940	1
RP00133	0	0	C00064	2	C00940	2
RP00133	0	0	C00064	4	C00940	4
RP00133	0	0	C00064	5	C00940	6
RP00133	0	0	C00064	6	C00940	5
RP00133	0	0	C00064	7	C00940	7
RP00133	0	0	C00064	8	C00940	8
RP00133	0	0	C00064	9	C00940	9
