MAPPING	0


RP00036	0	0	C00022	1	C00074	1
RP00036	0	0	C00022	2	C00074	2
RP00036	0	0	C00022	0	C00074	5
RP00036	0	0	C00022	4	C00074	0
RP00036	0	0	C00022	3	C00074	4
RP00036	0	0	C00022	5	C00074	3
