MAPPING	0


RP00625	0	0	C00025	0	C00439	2
RP00625	0	0	C00025	1	C00439	3
RP00625	0	0	C00025	2	C00439	1
RP00625	0	0	C00025	3	C00439	9
RP00625	0	0	C00025	4	C00439	4
RP00625	0	0	C00025	5	C00439	0
RP00625	0	0	C00025	6	C00439	8
RP00625	0	0	C00025	7	C00439	5
RP00625	0	0	C00025	8	C00439	7
RP00625	0	0	C00025	9	C00439	6
