MAPPING	0


RP01530	0	0	C00188	2	C00820	2
RP01530	0	0	C00188	3	C00820	3
RP01530	0	0	C00188	1	C00820	1
RP01530	0	0	C00188	6	C00820	7
RP01530	0	0	C00188	4	C00820	4
RP01530	0	0	C00188	7	C00820	6
RP01530	0	0	C00188	0	C00820	0
RP01530	0	0	C00188	5	C00820	5
