MAPPING	0


RP01103	0	0	C00022	1	C00097	0
RP01103	0	0	C00022	2	C00097	1
RP01103	0	0	C00022	0	C00097	2
RP01103	0	0	C00022	3	C00097	4
RP01103	0	0	C00022	5	C00097	5
