MAPPING	0


RP01119	0	0	C00090	0	C02480	1
RP01119	0	0	C00090	1	C02480	7
RP01119	0	0	C00090	2	C02480	0
RP01119	0	0	C00090	3	C02480	3
RP01119	0	0	C00090	4	C02480	6
RP01119	0	0	C00090	5	C02480	8
RP01119	0	0	C00090	6	C02480	2
RP01119	0	0	C00090	7	C02480	5
