MAPPING	0


RP04312	0	0	C00109	0	C06006	0
RP04312	0	0	C00109	1	C06006	2
RP04312	0	0	C00109	2	C06006	3
RP04312	0	0	C00109	3	C06006	4
RP04312	0	0	C00109	4	C06006	7
RP04312	0	0	C00109	5	C06006	8
RP04312	0	0	C00109	6	C06006	9
