MAPPING	0


RP10924	0	0	C00090	0	C00292	0
RP10924	0	0	C00090	1	C00292	2
RP10924	0	0	C00090	2	C00292	1
RP10924	0	0	C00090	4	C00292	5
RP10924	0	0	C00090	6	C00292	4
RP10924	0	0	C00090	7	C00292	6
